11111111111111111111111111111111
100CC0000000000CC0000CCCCCCCCCC1
1E0CP0000000E00CC000000000000001
100CC000000000000000011111111111
100CC0000000000CC0000CCCCCCCCCC1
100CC0000000000CC0000CCCCCCCCCC1
100CC0000000000CC0000CCCCCCCCCC1
100CC0000000000CC0000CCCCCCCCCC1
100CC0000000000CC0000CCCCCCCCCC1
100CC0000000000CC0000CCCCCCCCCC1
100CC0000000000CC0000CCCCCCCCCC1
100CC0000000000CC0000CCCCCCCCCC1
100CC0000000000CC0000CCCCCCCCCC1
100CC0000000000CC0000CCCCCCCCCC1
100CC0000000000CC0000CCCCCCCCCC1
100CC0000000000CC0000CCCCCCCCCC1
100CC0000000000CC0000CCCCCCCCCC1
100CC0000000000CC0000CCCCCCCCCC1
100CC0000000000CC0000CCCCCCCCCC1
11111111111111111111111111111111