1111111111111111111111
100CC0000000000CC00001
1E0CP0000000E00CC00001
100CC0000000000HH00001
1111111111111111111111